1111111111111111111111111111111111111
1E0000000000000000C00000C000000000001
1111111111100000000101001000000010101
1010000000111101010001001000000010101
1010010010111101010001001000C00010101
1010010010101101010001001000000010101
1010010010111101010001001000000010101
1010010C101111010100010C1000000010101
1111111110101101010001001001111000C01
1000C10010111101010001001000000010101
1010010010111101010001001000000010101
1010010010111101010001001000000010101
101001001011110101000100100C000010101
1010010010000101010001001000000010101
1P0000000C00CC000000000000000000000C1
1111111111111111111111111111111111111
