11111111111111111111
1E000000C00000C00001
10100000010100100101
10101001000100100101
1P00C0000000000000C1
1010100100C100100101
11111111111111111111
