11111111111111111111
1E000000C00000C00001
10100000010100100101
10101001000100100111
1P00C0000000000001C1
1010100100C100100101
11111111111111111111
