1111111111111111111111111111111111111111
1E0000000000000000000C00000C000000000001
1111111111100000000000101001000000010101
1010000000111000101010001001000000010101
1010010010111000101010001001000C00010101
1010010010101000101010001001000000010101
1010010010111000101010001001000000010101
1010010C101110001010100010C1000000010101
1111111110101001101010001001001111000C01
1000C10010111000101010001001000000010101
1010000000111000101010001001000000010101
1010010010111000101010001001000000010101
1010010C101110001010100010C1000000010101
1111111110101001101010001001001111000C01
1000C10010111000101010001001000000010101
1010010010111000101010001001000000010101
1010010010111000101010001001000000010101
101001001011100C10101000100100C000010101
101001001011100C10101000100100C000010101
1010010010000000101010001001000000010101
1P0000000C00C000C000000000000000000000C1
1010010C101110001010100010C1000000010101
1111011110101001101010001001001111000C01
1000C10010111000101010001001000000010101
1111111111111111111111111111111111111111
